    (1, 1),  # 0 = podlaha
    (1, 0),  # 1 = zed_s
    (4, 1),  # 2 = zed_v
    (1, 4),  # 3 = zed_j
    (0, 1),  # 4 = zed_z
    (1, 1),  # 5 = dvere ZATÍM JAKO PODLAHA
    (14, 1), # 6 = void
    (0, 0),  # 7 = LevýHorníRoh
    (4, 0),  # 8 = PravýHorníRoh
    (0, 4),  # 9 = LevýDolníRoh
    (4, 4),  # 10 = PravýDolníRoh


[6, 6, 6, 6, 6, 6, 6, 6, 6, 6, 6, 6, 6, 6, 6, 6, 6, 6, 6, 6, 6, 6],
[6, 6, 6, 6, 6, 6, 6, 6, 6, 6, 6, 6, 6, 6, 6, 6, 6, 6, 6, 6, 6, 6],
[6, 6, 6, 6, 6, 6, 6, 6, 6, 6, 6, 6, 6, 6, 6, 6, 6, 6, 6, 6, 6, 6],
[6, 6, 6, 7, 1, 1, 1, 1, 1, 1, 1, 1, 1, 1, 1, 1, 1, 1, 8, 6, 6, 6],
[6, 6, 6, 4, 0, 0, 0, 0, 0, 0, 0, 0, 0, 0, 0, 0, 0, 0, 2, 6, 6, 6],
[6, 6, 6, 4, 0, 0, 0, 0, 0, 0, 0, 0, 0, 0, 0, 0, 0, 0, 2, 6, 6, 6],
[6, 6, 6, 4, 0, 0, 0, 0, 0, 0, 0, 0, 0, 0, 0, 0, 0, 0, 2, 6, 6, 6],
[6, 6, 6, 4, 0, 0, 0, 0, 0, 0, 0, 0, 0, 0, 0, 0, 0, 0, 2, 6, 6, 6],
[6, 6, 6, 4, 0, 0, 0, 0, 0, 0, 0, 0, 0, 0, 0, 0, 0, 0, 2, 6, 6, 6],
[6, 6, 6, 4, 0, 0, 0, 0, 0, 0, 0, 0, 0, 0, 0, 0, 0, 0, 2, 6, 6, 6],
[6, 6, 6, 4, 0, 0, 0, 0, 0, 0, 0, 0, 0, 0, 0, 0, 0, 0, 2, 6, 6, 6],
[6, 6, 6, 9, 3, 3, 3, 3, 0, 5, 5, 5, 5, 0, 3, 3, 3, 3,10, 6, 6, 6],
[6, 6, 6, 6, 6, 6, 6, 6, 4, 0, 0, 0, 0, 2, 6, 6, 6, 6, 6, 6, 6, 6],
[6, 6, 6, 6, 6, 6, 6, 6, 4, 0, 0, 0, 0, 2, 6, 6, 6, 6, 6, 6, 6, 6],
[6, 6, 6, 6, 6, 6, 6, 6, 4, 0, 0, 0, 0, 2, 6, 6, 6, 6, 6, 6, 6, 6],
[6, 6, 6, 6, 6, 6, 6, 6, 4, 0, 0, 0, 0, 2, 6, 6, 6, 6, 6, 6, 6, 6],
[6, 6, 6, 7, 1, 1, 1, 1, 0, 0, 0, 0, 0, 0, 1, 1, 1, 1, 8, 6, 6, 6],
[6, 6, 6, 4, 0, 0, 0, 0, 0, 0, 0, 0, 0, 0, 0, 0, 0, 0, 2, 6, 6, 6],
[6, 6, 6, 4, 0, 0, 0, 0, 0, 0, 0, 0, 0, 0, 0, 0, 0, 0, 2, 6, 6, 6],
[6, 6, 6, 4, 0, 0, 0, 0, 0, 0, 0, 0, 0, 0, 0, 0, 0, 0, 2, 6, 6, 6],
[6, 6, 6, 4, 0, 0, 0, 0, 0, 0, 0, 0, 0, 0, 0, 0, 0, 0, 2, 6, 6, 6],
[6, 6, 6, 4, 0, 0, 0, 0, 0, 0, 0, 0, 0, 0, 0, 0, 0, 0, 2, 6, 6, 6],
[6, 6, 6, 9, 3, 3, 3, 3, 3, 3, 3, 3, 3, 3, 3, 3, 3, 3,10, 6, 6, 6],
[6, 6, 6, 6, 6, 6, 6, 6, 6, 6, 6, 6, 6, 6, 6, 6, 6, 6, 6, 6, 6, 6],
[6, 6, 6, 6, 6, 6, 6, 6, 6, 6, 6, 6, 6, 6, 6, 6, 6, 6, 6, 6, 6, 6],
[6, 6, 6, 6, 6, 6, 6, 6, 6, 6, 6, 6, 6, 6, 6, 6, 6, 6, 6, 6, 6, 6]
