#0 = podlaha
#1 = zed_s
#2 = zed_v
#3 = zed_j
#4 = zed_z
#5 = dvere
#6 = void


[6, 6, 6, 6, 1, 1, 1, 1, 1, 1, 1, 1, 1, 1],
[6, 6, 6, 6, 4, 0, 0, 0, 0, 0, 0, 0, 0, 2],
[0, 0, 0, 0, 4, 0, 0, 0, 0, 0, 0, 0, 0, 2],
[0, 0, 0, 0, 5, 0, 0, 0, 0, 0, 0, 0, 0, 2],
[0, 0, 0, 0, 4, 0, 0, 0, 0, 0, 0, 0, 0, 2]
[6, 6, 6, 6, 4, 0, 0, 0, 0, 0, 0, 0, 0, 2]
[6, 6, 6, 6, 4, 0, 0, 0, 0, 0, 0, 0, 0, 2]
[6, 6, 6, 6, 4, 0, 0, 0, 0, 0, 0, 0, 0, 2]
[6, 6, 6, 6, 4, 0, 0, 0, 0, 0, 0, 0, 0, 2]
[6, 6, 6, 6, 3, 3, 3, 3, 3, 3, 3, 3, 3, 3]
